100000000000000000000000000000000000000000000000000000000000000000000000000000000000000000000000000001111111111111111111111
100000000000000000000000000000000000000000000000000000000000000000000000000000000000000000000000001001111111111111111111111
100000000000000000000000000000000000000000000000000000000000000000000000000000000000000000100000000001111111111111111111111
100000000000000000000000000000000000000000000000000000000000000000000000000000000000000000000000000001111111111111111111111
100000000000000000000000000000000000000000000000000000000000000000000000000000000000000000000000000001111111111111111111111
100000000000000000000000000000000000000000000000000000000000000000000000000000000000010000000000100001111111111111111111111
100000000000000000000000000000000000000000000000000000000000000000000000000000000000000000000000000001111111111111111111111
100000022222200000000000000000000000000000000000000000000000000000000000000000000000000000000100000001111111111111111111111
100000000000000000000000000000222220000000000000000000000000000000000000000000000000000000000000000041111111111111111111111
140000000000004000000000000000000000000000000000000000000000000000000000000000010000000000000000000021111111111111111111111
122222222222202222222200000000000000002000000022000000000000000000000000000000000000000000000000000211111111111111111111111
111111111111101111111122222222222222221000022211200002222222222222222222222200000000000000000000002111111111111111111111111
111111111111101111111111111111111111111222211111122221111111111111111111111122222222222222222222221111111111111111111111111
111111111111100000000000000011111111111111111111111111111111111111111111111111111111111111111111111111111111111111111111111
111111111111110000000000000000000000001111111111111111111111111111111111111111111111111111111111111111111111111111111111111
111111111111111111111111111111111111111111111111111111111111111111111111111111111111111111111111111111111111111111111111111
111111111111111111111111111111111111111111111111111111111111111111111111111111111111111111111111111111111111111111111111111